11111111
1CCCCPE1
1CCC11C1
11111111