1111111
10P00C1
1E00001
1111111