11111111111111111111
100100C0000C00000001
10000111110000111001
100111000CC000100CC1
100100CE000C00000001
100P0110110000111001
1C0001000CC000100CC1
11111111111111111111
