11111111111111111111
100100C0000C00000001
10000111110000111001
100111E00CC000100CC1
100100C0000C00000001
10000111110000111001
1C0P11000CC000100CC1
11111111111111111111